40 24
#####o##########rrr#####################
#....@..........bbb....................#
#...............bbb....................#
#..fffffffffffffrrrffffffffffffffffff..#
#..f            rrr        g        f..#
#..f  w      g  rrr    t        w   f..#
#..f     t      rrr                 f..#
#..f       g    rrr    w        c   f..#
#..f            rrr                 f..#
#..f       w    rrr    g    t       f..#
#..f            rrr                 f..#
#..f            rrr     w    g      f..#
#..f    c       rrr   g             f..#
#..f            rrr       w    t    f..#
#..f            rrr                 f..#
#..f     t      rrr g   t   g       füü#
#..f  g         rrr              c  f..d
#..f            rrr       w         füü#
#..f     c      rrr                 f..#
#..f            rrr     g    t      f..#
#..fffffffffffffrrrffffffffffffffffff..#
#...............bbb....................#
#...............bbb....................#
################rrr#####################